"K": 3, "title": "", "M": 11, "N": 11
###########
#.........#
#.........#
#....s....#
#.........#
#.........#
#.........#
#.........#
#.........#
#......x..#
###########
direction 1 1 southeast
direction 4 1 southeast
optimal_path 3 8 south