"K": 0, "title": "", "M": 31, "N": 31
###############################
#.....#...............#.......#
#.#####.###.#.#######.#.#.###.#
#.....#.#.#.#.#.....#.#.#x..#.#
#####.#.#.#.###.###.#.#####.#.#
#...#.....#.......#.#.....#.#.#
#.#.###############.#####.#.#.#
#.#.................#.....#.#.#
#.###################.#####.###
#.......#...#...........#.....#
#.#####.#.###.#########.#####.#
#.....#.#.......#.....#.....#.#
###.###.#.#####.#.###.#####.#.#
#.#.#...#.#...#.#...#...#.#...#
#.#.#.#####.#.#.#.#####.#.###.#
#...#.......#.#.#.#.....#...#.#
#.###########.###.#.#####.#.#.#
#...#.......#.....#.#.....#...#
###.#######.#####.#.#.#########
#...#.....#.#...#.#.#.#...#...#
#.###.###.#.#.#.###.#.#.#.#.#.#
#...#.#.....#.#...#.#...#.#.#.#
###.#.#######.###.#.#####.###.#
#.#.#...#...#...#...#s..#.....#
#.#.#.#.#.#.###.###.###.#####.#
#.#.#.#...#...#...#.#...#.....#
#.#.#######.#.###.#.#.###.#####
#.#.#.....#.#...#.#.#.#.#.#...#
#.#.#.###.#####.#.###.#.#.#.#.#
#.....#.........#.....#.....#.#
###############################