"K": 0, "title": "", "M": 11, "N": 11
###########
#..x......#
#####.###.#
#.....#...#
#.#.#####.#
#.#.#...#.#
#.###.#.#.#
#.....#s#.#
#########.#
#.........#
###########