"K": 3, "title": "", "M": 11, "N": 21
###########
#s#.......#
#.#####.###
#.#...#...#
#.#.#.###.#
#.#.#.....#
#.#.#####.#
#...#.#...#
#####.#.###
#.....#...#
###.#.###.#
#...#.#...#
#.#####.###
#...#...#.#
###.#.###.#
#...#.#...#
#.###.#.###
#....x#...#
#.#######.#
#.........#
###########
direction 1 3 south
distance 13 9 5.65685424949
optimal_path 4 3 north