"K": 3, "title": "", "M": 11, "N": 19
###########
#.#....s#.#
#.#.#####.#
#.#.....#.#
#.#####.#.#
#.....#.#.#
###.#.#.#.#
#...#.#.#.#
#.#####.#.#
#.#...#.#.#
#.#.#.#.#.#
#...#.#.#.#
#####.#.#x#
#.....#...#
#.#######.#
#...#...#.#
#.#.#.#.#.#
#.#.......#
###########
direction 11 3 east
direction 3 1 southeast
optimal_path 13 2 west