"K": 12, "title": "", "M": 41, "N": 41
#########################################
#...#...#.............................#.#
#.............#...#..#.#........##......#
#.........#.....#.#.#...................#
#.#.....##..#.###.........#..#...#...#..#
#...........#.......#...................#
#..#..#......#..#...............#.....#.#
#.........#.................#...........#
#...........##....#....#..#.............#
#.......#.......................#.....#.#
#..#....#.#.#.#...##.......##.#.........#
#.....#...................#.............#
#...#.....#...............#.....#.#.....#
#.....#.....#...........#...............#
#.#..###......#...#.....###...........#.#
#.........#.....#...................#...#
#.##........#..#.#..........###.###.....#
#...........#....s..#.....#.............#
#...#...#....#...#..#...........##..#.###
#.......................................#
##..#...........#.#........#...##.#..#..#
#.......................#...............#
#..##.....#..##.#.##.....##..##.#.......#
#...................................#...#
#..#.......#..##....#..#......#.#...##..#
#...#.#.............#...#...............#
#.#..#............#.........#..#..#..#..#
#...........#...........................#
#.....#...#.#.......#.............#.....#
#.......................................#
#.#.....#.#....###..#.......#.##....#.#.#
#.......................................#
#....##...#.....#.#.....#............##.#
#.........................#...........#.#
#.#.#.#.......#...........#.#...........#
#.................#.....................#
#.#......##..#......#..#......#.....#...#
#.........#...#.......#...#.#...........#
#.#.###........#....###.#...#.#...#.#.#.#
#...........#...........x...........#...#
#########################################
direction 34 23 south
direction 24 5 southeast
direction 7 19 south
direction 25 14 southeast
distance 18 15 22.8473193176
distance 27 34 15.6204993518
distance 22 11 21.400934559
distance 13 32 27.2029410175
optimal_path 9 2 south
optimal_path 6 27 south
optimal_path 29 21 south
optimal_path 39 3 east