"K": 7, "title": "", "M": 21, "N": 29
#####################
#...............#...#
#.......#...###.....#
#...................#
#.....#...#.......#.#
#.#...#.............#
#.#......#..#..##.#.#
#.....#.............#
#.#.#.....#....#..#.#
#s..#.....#.......#.#
#.#.#.#....####.....#
#...#.#.#.......#.#.#
#...#.#.....#...#.#.#
#.#.#.#.....#.#.....#
#.#...#.#.###.#.##..#
#.#.#.#.#...........#
##..#.....#.#x#.#####
#...........#.......#
#...###.#..##.......#
#.................#.#
#.....#..##.#...###.#
#.................#.#
#...#####.#.###.....#
#.....#...#.........#
#.#.......###.#...#.#
#.#...#.....#.#.....#
#.....#.##....#.#.###
#...................#
#####################
direction 24 5 northeast
direction 3 5 southeast
optimal_path 17 15 west
optimal_path 27 9 east
optimal_path 1 14 east
optimal_path 19 6 east
optimal_path 2 1 south