"K": 7, "title": "", "M": 21, "N": 29
#####################
#.................#.#
#..###..###...##..#.#
#.......#.#.....#..x#
##.##.....#.###.###.#
#.....#.......#.....#
#..#.##.###.#.##..#.#
#.......#.........#.#
#.#........#..#.....#
#.#...#...#.....#...#
#.###.#.....#...###.#
#...........#.......#
#...#.#.....#...###.#
#...#...#.#.........#
#.###.....##.#....#.#
#.#.........#.....#.#
#.#.##......#.#.###.#
#.#.......#...#.....#
#.#..#.....#.##.##.##
#.........#.........#
#..#..#..##..#.#..#.#
#.....#...#.......#.#
###.#..##.#.##..###.#
#......s#.#.#.......#
#...##..#...#.#.#...#
#.......#.#.........#
#...#.#.#..##...###.#
#...#.....#.....#...#
#####################
direction 3 17 east
direction 9 12 northeast
optimal_path 20 2 north
optimal_path 27 14 north
optimal_path 19 17 east
optimal_path 18 10 west
optimal_path 21 14 north