"title": "", "M": 9, "N": 9, "color_file": "1.png", "beeps": [[6,5], [4, 5], [2, 7]]
#########
#.......#
#.......#
#.......#
#.......#
#.......#
#.s.....#
#.......#
#########